:::::::$$$:..:////:..////////..:::::
:::::::$$$:..///###..////////..:::::
:::::::$$$:..///###..////////..:::::
::::#::$$$:..//////............:::::
::###::$$$:..://://............:::::
::###:$$$::.........../////////:::::
................###.../////////:::::
...............###..../////////:::::
//////$$$:::....###.../////////:::::
/////$$$$:::.....##.../////////:::::
/////$$$::::........................
////$$$$::::..@.....................
////$$$$:::://///////////:::....////
////$$$::::://///////////:::....////
////$$$::::://///////////:::....////
////$$$:::::////$$$$$$$//:::....////
////$$$$::::$$$$$$$$$$$$/:::....////
////$$$$$$$$$$$$$$$$$$$$$:::....////
////$$$$$$$$$$$$..$$$$$$$$::....////
/////$$$$$$$$.......$$$$$$::....////