:::::::$$$:..:////:..////////..::::::::::::::::::::::::::::::::::::::::::::::::
:::::::$$$:..///###..////////..::::#####/###///////::::::::::::::::::::::::::::
:::::::$$$:..///###..////////..######:://///////:::::::::::..............::::::
::::#::$$$:..//////.................:::////###///////....//////######.........:
::###::$$$:..://://....................////////////....////###///////.........:
::###:$$$::.........../////////::::::::::://///////.....///////////.......:::::
................###.../////////:::::::::::////###////..............::::::::::::
...............###..../////////::::::::::://///////..............::::::::::::::
//////$$$:::....###.../////////::::::.........///////.................:::::::::
/////$$$$:::.....##.../////////:::::.............###..............:::::::::::::
/////$$$::::....................................#####....////////::::::::::::::
////$$$$::::.....................................###...////####///:::::::::::::
////$$$$:::://///////////:::....////.............###.../////###//::::::::::::::
////$$$::::://///////////:::....////.............###..///######::::::::::::::::
////$$$::::://///////////:::....////....$$$$$::#######:::::::::::::::::::::::::
////$$$:::::////$$$$$$$//:::....///////$$$$$::####$$####:::::::::::::::::::::::
////$$$$::::$$$$$$$$$$$$/:::....////////$$$$$::##$$$$##::::::::::::::::::::::::
////$$$$$$$$$$$$$$$$$$$$$:::..../////.....$$$$:::::::::::::::::::::::::::::::::
////$$$$$$$$$$$$..$$$$$$$$::....//////$$$$$::::::::::::::::::::::::::::::::::::
/////$$$$$$$$.......$$$$$$::....///////$$$$$:::::::::::::::::::::::::::::::::::
:::::::::::::::::::::::$$$$$$$$$$$$$$$$$$$$::::::::::::::::::::::::::::::::::::
::::::::::::::::::::::::::$$$$$$$$$$$$$$$::::::::::::::::::::::::::::::::::::::